***********************************
* *1 **************************** *
* *  *  *  *  *           *     * *
* *  *  *  *  *******  *  *  *  * *
* *     *     *        *     *  * *
* ****  *  *  *  *************  * *
* *     *  *        *  *  *     * *
* ****  *  *  *******  *  *  **** *
* *        *  *  *     *        * *
* *  *  ****  *  ****  *  ****  * *
* *  *  *  *  *  *  *  *     *  * *
* ****  *  ****  *  *  *  *  **** *
* *  *     *     *  *  *  *     * *
* *  *  ****  ****  *  *  ******* *
* *  *        *     *        *  * *
* *  *******  ****  *******  *  * *
* *              *        *     * *
* *  **********  *  ****  ****  * *
* *  *  *              *  *     * *
* *  *  *******  *  *  ****  *  * *
* *           *  *  *     *  *  * *
* **************************** 2* *
***********************************