***********************************************************************************************************************************************************
* ******************************************************************************************************************************************************* *
* *  *              *              *  *  *     *        *  *        *           *  *     *     *  *  *     *              *              *     *  *     * *
* *  *******  ****  ****  *******  *  *  ****  *  *  *  *  *  ****  ****  *******  *  ****  ****  *  *  *  *******  *******  *  ****  ****  *  *  ****  * *
* *     *     *        *     *              *     *  *        *     *  *                 *     *        *  *              *  *     *        *  *        * *
* *  *******  ****  *  *  *******  ****  *  **********  ****  ****  *  *  *  **********  *  *  ****  *******  *  *  ****  **********  *******  *  ****  * *
* *     *        *  *  *  *           *  *        *  *  *     *  *        *     *     *     *     *        *  *  *  *  *  *  *           *     *  *  *  * *
* *  **********  ****  ****  *******  ****  *******  **********  *  **********  *  *******  ****  *  *  *******  ****  *  *  *  ****  *  *******  *  *  * *
* *              *        *  *     *  *  *     *     *           *  *  *           *        *        *     *  *  *        *  *     *  *  *  *        *  * *
* *******  *  ****  *  *  *  *  ****  *  *******  *  ****  ****  *  *  *******  *  *  **********  *  ****  *  **********  *  *  *******  *  ****  ******* *
* *     *  *     *  *  *  *  *     *     *  *     *  *  *  *        *  *        *  *  *  *  *     *  *     *  *           *     *     *                 * *
* *  ****  *************  *  ****  *******  *  ****  *  *************  ****  *  *  ****  *  *******  ****  *  ****  ****  *  ****  *******  *  *******  * *
* *     *  *                    *        *  *     *  *        *        *  *  *  *  *     *     *     *  *  *           *     *           *  *     *     * *
* *  ****  *  *  *  *  ****  ****  *  *  *  *  *  *  ****  *  *  ****  *  ****  ****  ****  *  *******  *  *  *  *******  *******  *  *******  *******  * *
* *     *  *  *  *  *  *     *  *  *  *  *  *  *  *     *  *        *     *              *  *     *        *  *        *  *  *  *  *        *        *  * *
* *  *******************  *  *  ****  ****  ****  *******************  *******  ****************  *  ****  ****  *  ****  *  *  ****  *  ****  *  *  *  * *
* *  *     *     *        *        *  *  *           *  *     *        *     *     *           *        *        *  *  *     *  *  *  *     *  *  *  *  * *
* *  *  *  ****  ****  ****  *******  *  ****  *******  *  **********  *  *  *******  *  *******  *  *******  *******  *  ****  *  *  *  *************  * *
* *     *     *  *        *        *     *     *     *  *     *        *  *           *  *        *  *     *        *  *  *     *  *  *     *  *  *     * *
* ****  *******  *  *  *******  *  ****  *  *  ****  *  ****  ****  ****  ****  ****  *  *******  ****  *  *  *  ****  *  ****  *  ****  ****  *  ******* *
* *     *  *        *  *  *     *  *  *  *  *     *     *  *  *              *     *  *     *     *     *  *  *  *                    *        *        * *
* ****  *  ****  ****  *  **********  *  ****  ****  *  *  *  *******  *******************  ****  *  ****  *  *************  *******  *  *******  ******* *
* *        *     *  *     *  *  *        *  *        *        *           *  *     *     *     *        *  *  *           *  *        *                 * *
* ****  ****  *  *  *  *  *  *  *  *******  *******  ****  ****  ****  ****  *  *******  **********  ****  *  ****  *************  *  *  *  ****  *  *  * *
* *  *  *  *  *  *     *  *        *     *     *        *  *  *     *  *  *     *     *  *     *        *  *     *           *  *  *     *     *  *  *  * *
* *  *  *  ****  *  ****  *  ****  ****  *  *  *******  ****  *  *******  *  ****  ****  ****  ****  ****  ****  **********  *  *  ****  *******  ****  * *
* *  *     *     *     *     *  *        *  *        *     *     *  *        *        *  *           *     *  *     *  *     *  *  *        *        *  * *
* *  *  *  *  ****************  ****  **********  *  ****  ****  *  *  *  ****  *  *  *  **********  *******  *  ****  *  *  *  ****  *  *************  * *
* *  *  *     *  *     *  *     *     *           *     *           *  *  *     *  *  *     *           *  *     *  *     *        *  *  *  *     *     * *
* *  *******  *  *  ****  *  ****  *  **********  *******  *  ****  *  **********  *  ****  ****  *******  *  ****  ****  ****  *  ****  *  ****  *  **** *
* *                          *  *  *  *  *                 *     *  *  *           *     *        *  *  *        *     *  *  *  *     *  *     *     *  * *
* *  *******  **********  ****  ****  *  ****  *  **********  *******  **********  *******  *  *  *  *  *******  ****  *  *  *  *************  *  *  *  * *
* *        *     *              *        *     *  *                 *           *  *  *     *  *        *        *        *  *        *     *  *  *  *  * *
* *  *************  *******  ****  *  *  ****  *************  *  *******  *******  *  ****  ****  *  ****  ****************  ****  *  ****  *  *******  * *
* *     *                 *  *  *  *  *  *  *  *     *        *     *     *                 *     *  *     *     *     *        *  *              *     * *
* *  *******  *************  *  **********  *******  *  ****  ****  *  ****  *  *******  *  *******  *******  ****  **********  *******  ****  *******  * *
* *        *     *        *     *  *  *  *  *  *  *  *     *  *              *  *  *  *  *        *     *  *  *  *     *                    *  *     *  * *
* *  *******  ****  ****  *  *  *  *  *  *  *  *  *  *  *  *  *  ****************  *  *******************  *  *  *  **********  *******  *  ****  ****  * *
* *  *        *        *     *                          *  *  *           *  *        *  *           *     *        *              *  *  *  *  *        * *
* *  ****  ****  ****  *************  *******  ****  *  ****  *************  *******  *  *  *************  ****  *******  *  ****  *  *  *  *  *  ******* *
* *     *     *  *              *        *  *  *     *  *                          *  *  *        *                 *     *  *     *     *              * *
* **********  *  ****  *  ****************  *  *******  *  *  ****  *  *******  ****  *  *  *************  ****************  *  ****  *  ****  ****  *  * *
* *  *  *  *  *     *  *  *        *           *  *     *  *     *  *     *  *                 *  *     *           *  *  *  *  *     *     *     *  *  * *
* *  *     *  *           *     *           *  *  *     *  *        *              *     *  *     *  *     *     *  *        *        *        *     *  * *
* *  ****  *  *******  *******  *  *  ****  ****  *  ****  *  *  *************  **********  ****  *  *  *  ****  *  ****  *  *******  **********  ****  * *
* *  *  *  **********  *******  ****  *******  *  ****  *  ****************  ****  ****  *******  *  ****  *  *******  *  ****  *******  **************** *
* *           *           *     *  *     *  *        *     *  *     *  *     *                 *        *  *  *  *  *     *              *  *  *     *  * *
* ****  ****  *  ****  ****  **********  *******  *  *  ****  *  ****  *  ****  ****  ****************  ****  *  *  *  ****  *  **********  *  *  ****  * *
* *  *  *     *  *        *  *           *     *  *  *     *  *     *              *              *  *        *           *  *  *        *              2 *
* *  *******  *************  ****************  ****  *************  *  ****  *******  *************  *******  *******  *  ****  *  ****  *  ****  *  **** *
* *                    *              *              *        *  *     *     *     *     *        *  *  *  *     *     *     *  *  *        *  *  *     * *
* *******  *******  *  *  *******  **********  ****  *  *******  **********  *  *  ****  *  ****  *  *  *  *  *  *******  **********  *******  *******  * *
* *  *  *  *        *     *     *        *  *     *     *  *  *        *        *  *     *  *        *        *  *        *  *              *        *  * *
* *  *  *  *************  *  *  *******  *  *******  *  *  *  *******  ****  *******  *  *******  *******  **********  *  *  **********  *  *  ****  *  * *
* *     *     *              *  *                 *  *        *        *  *     *  *  *        *  *           *  *     *     *        *  *  *  *     *  * *
* ****  *******  ****  ****  *  *******  **********  *******  *  ****  *  *  *  *  *  ****  *  *  *  *  *  ****  *******  *  *  *******  *******  ****  * *
* 1        *        *  *     *  *     *        *        *           *  *     *     *  *  *  *        *  *  *  *  *  *  *  *  *        *        *     *  * *
* *  ****  *  *  *  *  *  **********  ****  *  ****  ****  *  *  **********  *  *******  *******  ****  *  *  *  *  *  *  *  *  *  **********  *  ****  * *
* *     *  *  *  *  *  *     *              *  *  *     *  *  *  *        *  *        *  *     *     *  *     *           *  *  *        *     *        * *
* *  *  *******  ****  ****  ****  *  ****  ****  *  *******  *  *  ****  ****  *******  *  ****  *******  ****************************  ****  *  *  **** *
* *  *  *        *        *     *  *     *           *        *  *  *  *  *  *  *  *  *  *           *     *     *              *  *  *     *  *  *     * *
* ****  *  ****  ****  ****************  *  *******  *  *************  *  *  *  *  *  *  ****  **********  *  *  ****  *******  *  *  ****  ****  ******* *
* *     *     *     *  *     *  *  *     *  *     *  *  *  *     *           *     *        *     *     *     *  *        *              *           *  * *
* ****  *  *******  ****  *  *  *  **********  ****  ****  *  ****  *  *  *  *  *******  **********  *  ****  *************  *  ****  *  *  *  *******  * *
* *     *  *        *  *  *  *              *  *  *  *        *  *  *  *  *        *              *  *  *  *  *  *        *  *  *  *  *  *  *     *     * *
* ****  ****  *  ****  *  *  *******  *  ****  *  *  ****  *  *  *  *  *************  *  *  **********  *  ****  ****  *  *  ****  **********  ****  *  * *
* *           *  *  *  *  *  *  *  *  *        *        *  *     *  *                 *  *  *        *           *     *  *     *           *     *  *  * *
* ****  *******  *  *  *  *  *  *  *******  *******  *  ****  *  *******  ****************  ****  ****  *  *************  *  ****  *  **********  *  **** *
* *  *  *  *        *     *  *        *     *     *  *  *  *  *  *     *        *  *  *  *  *        *  *     *        *           *     *  *  *        * *
* *  *  *  ****  *******  *  *  *******  *  ****  *  ****  ****  *  ****  *******  *  *  *  *  ****  *  **********  ****  *  *  *******  *  *  *  ****  * *
* *        *  *  *  *     *        *     *  *     *     *  *     *  *  *  *     *              *              *  *        *  *     *     *  *     *     * *
* **********  ****  *******  ****  ****  *  *  *******  *  *  ****  *  ****  ****  *  ****  *******  *******  *  ****  *  ****  *  *******  *******  **** *
* *        *  *     *     *     *  *  *  *  *        *     *           *  *     *  *     *  *  *  *        *        *  *     *  *  *     *     *     *  * *
* *  *******  *  *******  ****  ****  *  ****  *  *  *  *  ****  *  ****  *  *******  *******  *  ****  *************  ****  ****  *  *******  *  ****  * *
* *  *  *           *     *  *  *  *           *  *     *     *  *  *        *           *  *     *        *           *        *              *        * *
* *  *  ****  ****  *  ****  *  *  ****  *******  ****  *  *  *  ****  **********  *******  ****  *  *******  *******  **********  ****  *******  *  **** *
* *           *  *              *        *        *     *  *  *           *  *        *     *  *              *  *     *     *        *        *  *  *  * *
* *  *******  *  *  ****  **********  *******  ****  *************  *******  *  *  *  ****  *  ****  *******  *  *******  ****  ****************  ****  * *
* *        *     *  *              *  *        *     *     *     *     *        *  *  *  *     *           *  *              *              *           * *
* *  **********  ****  **********  *******  ****  ****  *  *  ****  ****  **********  *  ****  ****  ****  *  *  ****  *  *  *******  *  *************  * *
* *     *  *     *     *        *  *           *  *     *     *     *  *  *     *  *     *     *  *     *  *        *  *  *     *     *  *  *           * *
* *  ****  *******  ****  ****  *******  *  *  *  *  ****  *  ****  *  *******  *  *  *  *  ****  ****  *  *  *  ****************  *  ****  *  *******  * *
* *  *        *  *  *        *     *     *  *  *        *  *              *     *  *  *           *     *  *  *  *     *           *                 *  * *
* ****  *******  *  *  *  *  *  *  *  *************  *  *************  ****  ****  *  *******  *******  ****  ****  *  ****************  *  **********  * *
* *                    *  *  *  *  *     *  *  *     *  *     *  *              *           *        *     *  *     *           *        *           *  * *
* *  *  ****  *  *******************  ****  *  *******  ****  *  ****  *******  *******  *  ****  ****  *******  *  *******  *************  ****  ******* *
* *  *  *     *     *  *           *              *              *     *              *  *  *     *           *  *        *     *           *     *  *  * *
* *******  *  *  ****  ****  *  *  *  *  *  **********  ****  *  *  *******  *  ****  *  ****  **********  *******  *  *  *  **********  **********  *  * *
* *     *  *  *     *     *  *  *     *  *  *  *  *  *     *  *  *  *        *  *     *     *  *     *        *     *  *  *     *  *     *     *  *  *  * *
* *  *  *  ****  *  *  *  ****  *  *******  *  *  *  *  *  *  *  ****  *******  ****************  *  *  *  ****  **********  ****  ****  *  ****  *  *  * *
* *  *     *  *  *     *     *  *        *  *     *     *  *  *  *     *        *     *     *  *  *     *        *        *     *           *           * *
* *  *******  **********  ****  *  ****  *******  *******  **********  ****  ****  *  ****  *  *******  ****  *  ****  ****  *  *************  *  ****  * *
* *        *           *  *     *     *     *  *     *     *  *  *     *        *  *     *  *  *     *  *  *  *  *  *        *  *  *        *  *  *     * *
* *  *  *  *  **********  ****  *  ****  ****  *  **********  *  *  ****  *  *  ****  ****  *  *  *******  *  ****  **********  *  *******  **********  * *
* *  *  *              *        *  *        *        *           *  *     *  *        *        *  *        *  *        *  *                 *           * *
* *******  *******  ****  *******  ****  **********  *  *  *  *************  ****  *******  ****  *******  *  *  ****  *  *******  *************  ****  * *
* *        *  *     *        *     *           *        *  *     *     *  *  *  *              *                 *        *           *  *  *        *  * *
* **********  *******  *******  *************  *  *  *******  ****  ****  *  *  *  *  ****  ****  ****  *  *******  *  *******  *******  *  ****  ****  * *
* *     *        *  *  *  *  *  *           *     *        *           *  *     *  *     *     *  *  *  *  *     *  *  *  *  *                 *     *  * *
* *  *******  *  *  *  *  *  ****  *******  *  *  *  *  *******  *  ****  *  **********  ****  *  *  ****  *  **********  *  *  *******  ****  *  ****  * *
* *           *                 *     *        *  *  *     *     *        *     *           *  *        *     *                 *           *     *     * *
* ******************************************************************************************************************************************************* *
***********************************************************************************************************************************************************