**************************************************
* *****2**************************************** *
* ***** **************************************** *
* ***** **************************************** *
* ***** **************************************** *
* *****       ********************************** *
* *********** ********************************** *
* *********** ********************************** *
* *********** ********************************** *
* ***********                ******************* *
* ************************** ******************* *
* ************************** ******************* *
* **************************        ************ *
* ********************************* ************ *
* ************************          ************ *
* ************************ ********************* *
* ************************ ********************* *
* ************************ ********************* *
* ************************ ********************* *
* ************************ ********************* *
* ************************ ********************* *
* ************************     ***************** *
* **************************** ***************** *
* **************************** ***************** *
* *****                        ***************** *
* ***** **************************************** *
* *****                             ************ *
* *********************************1************ *
**************************************************