*****************
* ************* *
* *  **       1 *
* *     ******* *
* *        **** *
* **          * *
* *     **** ** *
* ********** ** *
* *           * *
* *    ******** *
* *        *  * *
* ********    * *
* *********2*** *
*****************