**************************************************
* *****1**************************************** *
* ***** **************************************** *
* ***** **************************************** *
* ***** **************************************** *
* *****       ************           *********** *
* *********** **********************        **** *
* ******      ***** *********           ******** *
* **      *** * *** **************************** *
* ***********     **********  ****************** *
* ******                     ***** ************* *
* ************************** ******************* *
* ******            ********        ************ *
* ********************************* ************ *
* ************************          ************ *
* *****         **********   ******** ********** *
* ***********               ******************** *
* ************************  ******************** *
* ********          ******                ****** *
* ****            ******** ********************* *
* *********   ************ ********************* *
* *******          *******     **********      * *
* ***     ******************** ***************** *
* *******           ********** ***************** *
* *****                        *******      **** *
* ***** *****         **       *       ********* *
* *****       **********            ************ *
* *********************************2************ *
**************************************************